1111111111111111111111111111111111111111111111111111111111
1P1010000100001000000C001000000100C0000000C0100C0001CCCCC1
10101010C010010000000000100C001000000000001010000001CCCCC1
101010010010010001000C001000010000C00000010100000001111101
100010100010000100000C00100C001000000000001010000000000001
1010000100100000010000001000001000000000010001000000000001
1010000100111001100000000000001000000000010010000000000001
10000001000010000111111000000010000C00C0010011111110100001
10101C010010100000000C100000000000C01111000000000000100001
10C0100100101111111110101111111111100000011111100000111111
1010C010001000C000000C100000000C001000000000001000C00000E1
1111111111111111111111111111111111111111111111111111111111